LLLLLLLLLLLLLLLLLLLL
LLLLLLLLLLLLLLLLLLLL
LLLLPPPPPPPPPPPPPPLL
LLLLPLLLLLLLLLLLLPLL
LLLLPLLLLLLLLLLLLPLL
SPPPPLLLPPPPPPLLLPLL
LLLLLLLLPLLLLPLLLPLL
LLLLLLLLPLLLLPLLLPLL
FPPPPLLLPLLLLPLLLPLL
LLLLPLLLPLLLLPLLLPLL
LLLLPLLLPLLLLPLLLPLL
LLLLPLLLPLLLLPLLLPLL
LLLLPPPPPLLLLPPPPPLL
LLLLLLLLLLLLLLLLLLLL
LLLLLLLLLLLLLLLLLLLL


